TILEMAP
20 15 -- Size of tile map in tiles
32 32						-- Tile size & block size
../images/grass_night.png 	-- Tilesheet
5 6						-- Number of tiles in tilesheet
10 11 11 11 11 12 10 11 11 11 11 11 11 11 11 11 11 11 11 12
15 16 16 16 27 17 15 16 16 16 16 16 16 16 16 16 16 16 27 17
15 16 27 27 16 17 15 16 16 26 16 16 16 16 27 16 16 16 27 17
15 16 16 16 16 17 15 16 16 16 27 16 16 16 16 16 16 16 16 17
15 16 16 16 16 17 15 16 16 16 16 16 16 16 16 16 16 16 16 17
15 27 16 16 27 17 15 16 16 16 16 16 16 16 16 16 16 16 16 17
20 21 21 21 21 22 15 16 16 16 16 16 16 16 16 16 16 16 16 17
4 4 4 4 4 4 15 16 16 16 16 16 16 16 16 26 16 16 16 17
4 4 4 4 4 4 15 16 27 16 16 16 16 16 16 16 16 27 16 17
4 4 4 4 4 4 15 16 16 16 16 16 27 16 16 16 16 16 16 17
4 4 4 4 4 4 15 16 16 26 16 16 16 16 16 16 16 16 16 17
4 4 4 4 4 4 15 16 16 16 16 16 16 16 16 16 16 26 16 17
4 4 4 4 4 4 20 21 21 21 21 21 21 21 21 21 21 21 21 22
4 4 4 4 4 4 4 4 4 4 4 4 4 4 4 4 4 4 4 4
4 4 4 4 4 4 4 4 4 4 4 4 4 4 4 4 4 4 4 4
