TILEMAP
20 15 -- Size of tile map in tiles
32 32						-- Tile size & block size
../images/walls2.png 	-- Tilesheet
16 1							-- Number of tiles in tilesheet
13 4 4 4 4 13 4 4 4 4 4 4 4 4 4 4 4 4 4 13
9 11 11 11 11 9 11 11 11 11 11 11 11 11 11 11 11 11 11 9
9 11 11 11 11 9 11 11 11 11 11 11 11 11 11 11 11 11 11 9
9 11 11 11 11 9 11 11 11 11 11 11 11 11 11 11 11 11 11 9
9 11 11 11 11 9 11 11 11 11 11 11 11 11 11 11 11 11 11 9
9 11 11 11 11 9 11 11 11 11 11 11 11 11 11 11 11 11 11 9
1 4 4 4 4 13 11 11 11 11 11 11 11 11 11 11 11 11 11 9
11 11 11 11 11 9 11 11 11 11 11 11 11 11 11 11 11 11 11 9
11 11 11 11 11 9 11 11 11 11 11 11 11 11 11 11 11 11 11 9
11 11 11 11 11 9 11 11 11 11 11 11 11 11 11 11 11 11 11 9
11 11 11 11 11 9 11 11 11 11 11 11 11 11 11 11 11 11 11 9
11 11 11 11 11 9 11 11 11 11 11 11 11 11 11 11 11 11 11 9
11 11 11 11 11 1 4 4 4 4 4 4 4 4 4 4 4 4 4 5
11 11 11 11 11 11 11 11 11 11 11 11 11 11 11 11 11 11 11 11
11 11 11 11 11 11 11 11 11 11 11 11 11 11 11 11 11 11 11 11
