TILEMAP
20 15 -- Size of tile map in tiles
32 32							-- Tile size & block size
../images/lpc_terrain/twosided/redsandwater.png -- Tilesheet
5 6						-- Number of tiles in tilesheet
10 11 11 11 12 19 10 11 11 12 19 19 19 19 19 19 19 19 19 19
15 25 16 27 6 11 7 16 16 6 11 11 11 11 11 11 11 12 0 19
15 16 27 16 16 16 25 16 26 16 25 16 27 26 16 25 16 17 19 19
15 25 16 26 1 21 2 16 27 1 21 21 21 21 21 2 27 17 19 19
20 21 21 21 22 19 20 21 21 22 19 19 19 5 19 15 16 17 19 19
5 19 19 10 11 11 11 11 11 11 11 11 11 11 11 7 16 17 19 19
19 19 19 15 16 26 16 16 26 16 16 16 16 25 16 25 16 17 19 19
19 19 19 15 16 16 25 26 16 26 16 26 26 16 27 16 16 17 19 19
19 19 19 15 16 27 16 16 27 16 16 16 16 27 16 26 25 17 19 19
19 5 0 15 16 16 16 27 16 26 26 27 27 16 26 16 27 17 19 19
19 19 19 15 16 26 16 27 16 26 25 16 26 26 16 16 16 17 19 19
19 19 19 15 16 16 16 26 25 16 25 27 16 16 16 27 16 17 19 19
19 19 19 15 16 16 16 16 16 16 16 16 16 16 27 16 26 17 19 19
19 0 19 20 21 21 21 21 21 21 21 21 21 21 21 21 21 22 19 19
19 19 19 19 19 19 19 19 19 19 19 19 19 19 19 19 19 19 19 0
