TILEMAP
20 15 -- Size of tile map in tiles
32 32						-- Tile size & block size
../images/grass_night.png 	-- Tilesheet
5 6						-- Number of tiles in tilesheet
4 4 4 4 4 4 4 4 4 4 4 4 4 4 4 4 4 4 4 4
4 10 11 12 10 11 11 11 11 12 4 4 4 10 11 11 11 11 12 4
5 15 16 17 15 16 16 16 16 17 4 4 4 15 16 16 16 16 17 4
4 15 27 17 15 16 1 2 16 17 10 11 11 7 16 1 2 16 17 4
4 15 16 17 15 16 17 15 16 17 15 25 26 27 16 17 15 26 17 4
4 15 16 17 15 16 17 15 27 17 15 16 16 16 16 17 15 16 17 5
4 15 16 17 15 16 17 15 16 17 15 16 25 26 27 17 15 26 17 4
5 15 16 17 15 27 17 15 16 17 15 16 16 16 16 17 15 16 17 4
4 15 16 17 15 16 17 15 16 17 15 25 26 27 16 17 15 16 17 4
4 15 16 17 15 16 17 15 16 17 15 16 16 16 16 17 15 16 17 5
4 15 16 6 7 16 17 15 16 6 7 16 1 21 21 22 15 16 17 4
5 15 27 16 16 16 17 15 27 16 16 27 17 4 4 4 15 25 17 4
4 20 21 21 21 21 22 20 21 21 21 21 22 4 4 4 20 21 22 4
4 4 4 4 4 4 4 4 4 4 4 4 4 4 4 4 4 4 4 4
4 4 4 4 4 4 4 4 4 4 4 4 4 4 4 4 4 4 4 4
