TILEMAP
20 15 -- Size of tile map in tiles
32 32							-- Tile size & block size
../images/lpc_terrain/twosided/wheat.png -- Tilesheet
5 6						-- Number of tiles in tilesheet
19 10 11 12 19 25 19 10 11 11 11 11 11 12 19 10 11 11 12 19
19 15 16 6 11 11 11 7 16 16 16 16 16 17 19 15 16 16 17 19
19 15 16 16 16 16 16 16 16 16 16 16 16 17 19 15 16 16 17 19
19 15 16 16 16 16 16 16 16 16 16 16 16 17 19 15 16 16 17 19
19 20 21 21 2 16 16 16 16 16 16 16 16 6 11 7 16 16 17 19
4 27 4 10 7 16 16 16 16 16 16 16 16 16 16 16 16 16 17 19
4 4 4 15 16 16 16 16 16 16 16 16 16 1 21 2 16 16 17 19
4 4 19 15 16 16 16 16 16 16 16 16 16 17 19 15 16 16 17 19
25 4 19 15 16 16 16 16 16 16 16 16 16 17 25 15 16 16 17 19
4 4 10 7 16 16 16 16 16 16 16 16 16 17 19 20 21 21 22 19
4 4 15 16 16 16 16 16 16 16 16 16 16 6 11 12 4 4 4 4
4 4 15 16 16 16 16 16 16 16 16 16 16 16 16 17 4 25 4 4
4 4 15 16 16 16 16 16 16 16 16 16 16 16 16 17 4 25 27 4
25 4 20 21 21 21 21 21 21 21 21 21 21 21 21 22 4 4 25 4
4 4 4 4 4 4 4 4 4 4 27 4 4 4 4 4 25 4 4 4
