TILEMAP
16 16 							-- Size of tile map in tiles
16 16 							-- Tile size & block size
../images/tileset.png 	-- Tilesheet
10 28							-- Number of tiles in tilesheet
32 56 56 56 56 56 56 56 56 56 56 56 56 56 56 30
33 21 21 21 21 21 21 21 21 21 21 21 21 21 21 34
12 12 12 12 12 12 12 12 12 12 12 12 12 12 12 12
12 12 12 7 12 12 6 12 12 3 12 12 6 12 12 12
50 50 51 50 50 50 50 50 50 51 50 50 51 50 51 57
51 51 51 50 51 50 50 50 58 52 51 50 51 50 57 57
50 51 50 58 50 50 50 50 50 50 50 50 50 50 57 58
50 52 50 50 50 50 51 50 50 51 50 50 50 57 57 57
57 50 52 50 50 50 50 51 50 50 50 51 52 50 50 57
57 52 52 52 52 52 52 50 50 52 51 50 50 57 51 51
57 50 52 52 51 58 50 50 50 57 57 57 57 57 57 57
57 57 57 52 50 50 50 50 57 16 16 16 16 16 16 16
57 57 57 57 57 57 51 57 16 16 17 17 17 17 17 17
57 58 57 57 57 57 57 16 16 17 56 56 56 56 56 56
57 58 57 57 57 57 16 16 17 56 56 56 56 56 56 56
58 58 57 57 57 16 16 16 56 56 56 56 56 56 56 56

